1111111111111111111
1000010000100011001
100000010E000000001
110000C1100C111C001
1111111111111111111