1111111111111111111
10000100C0100011001
100000010P000000E01
110000C1100C111CC01
1111111111111111111