1111111111111111111
10000100C0100011001
100000010E000000P01
110000C1100C111C001
1111111111111111111