1111111111111111111
10000100C0100000001
100K00010P00000KE01
110000C1100C101CC01
110C000000011000001
1111111111111111111