1111111111111111111
10000100C0100000001
100K00010P00000KE01
110000C1100C101C0K1
110C0000000110000C1
1111111111111111111