111110111111111
100000000000001
100000000000001
190000000000000
100000000000011
100000000000001
111111011111111
