111111111111111
100000000000001
100000000000000
190000000000001
100000000000011
100000000000001
111111111111111